111111111111111111111111111111
1P0000000000000000000000000011
100100010010011001110011100011
100110110111010100100110110011
100101010101011000100100010011
100100010111010100100110110011
100100010101010101110011100011
10C001000CC00C0000100001010011
10C001110000000011100001E10011
10000001111C011110000011010011
100000000000000000000010010011
1000E0000001100000000010100011
100000000000000000000000000011
111111111111111111111111111111
