111111111111111111
1110000P00000C0001
110000010001000011
100001111E11000011
111111111111111111
