111111111111111111
111G000P00000C0001
1100000100010G0011
100001111E11000011
111111111111111111
