11111111111111111111111111111
1PCG0000000000G0C0G0000000001
10G1000100100110C111001110001
1001101101110101C010011011001
10010101010101100010010001C01
10010001011101010010011011C01
10010001010101010111001110C01
10000000000000000000000000001
100111000G000G00011100CC00001
1000010000C0C0000100000000001
100001110010100111000000E0001
1000E001111011110000000000001
10C00000000000000000000000001
11111111111111111111111111111
